NO ./textures/cobble_stone_wall.png
SO ./textures/red_brick_wall.png
WE ./textures/wood_wall.png
EA ./textures/mossy_brick_wall.png

F 150,0,100
C 250,250,250

111111111111111111111111
101
101
101
101
101
101           00E000
101
101
101
101
101
111
