







NO ./textures/cobble_stone_wall.png







SO ./textures/red_brick_wall.png
                        WE ./textures/wood_wall.png        
						EA ./textures/mossy_brick_wall.png            

        F 20,           20,             20
C 200,          200,200

11111
10001
10S01                
10001
10001
10001
11111
11001               
10001
10001
10001
10001
10001
11111           

        

























































































































































































































































































































































































































































































































































11111































































































































































































































































































































































































































































































































































































































































































































































































