NO ./textures/IMG_5452.png
SO ./textures/IMG_2709.png
WE ./textures/IMG_2709.png
EA ./textures/IMG_5452.png

F 20,20,20
C 200,100,0




11111
10001
10001
10001
10001
10001
11001
10001
10001
10W01
10001
10001
11111
11111111111111111111111
