NO ./textures/cobble_stone_wall.png
SO ./textures/red_brick_wall.png
WE ./textures/wood_wall.png
EA ./textures/mossy_brick_wall.png

F 20,20,20
C 200,200,200

111
101
101
101
101
101
101
101
101
101
101
1S1
111


11111111