SO ./textures/cobble_stone_wall.png
NO ./textures/red_brick_wall.png
WE ./textures/wood_wall.png
EA ./textures/mossy_brick_wall.png

F 20,20,20
C 210,200,200
111111111111111111
100000000000000001
100000010000000001
10000000N000000001
100000010000000001
100000000000000001
100000000000000001
111111111111111111
