NO ./textures/cobble_stone_wall.png
SO ./textures/red_brick_wall.png
WE ./textures/wood_wall.png
EA ./textures/mossy_brick_wall.png

F 0,0,255
C 200,200,200
1111
1001
1111
