NO ./textures/cobble_stone_wall.png
EA ./textures/mossy_brick_wall.png
SO ./textures/red_brick_wall.png
WE ./textures/wood_wall.png

F 220,100,0
C 225,30,0



    1111111111
    1000111001
11111N00100001
1000000001111
11111111111111111111