NO ./textures/fun_wall.png
EA ./textures/fun_wall.png
SO ./textures/fun_wall.png
WE ./textures/fun_wall.png

F 90,90,0
C 0,90,90


11111111111111111111111111111
10000000000000000000000000001
10000000000000000000000000001
10000000000000000000000000001
10000000011111111110000000001
10000010000000000000010000001
10000010000000000000010000001
10000010000000N00000010000001
10000010000000000000010000001
10000010000000000000010000001
10000000011111111100000000001
10000000000000000000000000001
10000000000000000000000000001
10000000000000000000000000001
11111111111111111111111111111
