NO ./textures/cobble_stone_wall.png
EA ./textures/mossy_brick_wall.png            a
SO ./textures/red_brick_wall.png
WE ./textures/wood_wall.png

F 220,100,0
C 225,30,0

11111
10011
10E11
11111